######..............
#...................
#...................
....................
....................
....................
.............#......
.............#......
...........#####....
.............#......
.............#......
..####..............
.....#..............
....................
....................