....................
..####..............
....................
....................
....................
.....#########......
....................
....................
....................
....................
....................
.....#####...#####..
....................
....................
....................